-14
15
-14
13
11111111111111111111111111111
12222210000000000000001222221
12222210000000000000001222221
12222210000000000000002222221
12222210000000000000002222221
11122110000000000000001111111
10000000000000000000000000001
10000000000000000000000000001
10000000000000000000000000001
10000000000000000000000000001
10000000000000000000000000001
10000000000000000000000000001
10000000000000000000000000001
10000000000000000000000000001
10000000000000000000000000001
10000000000000000000000000001
10000000000000000000000000001
10000000000000000000000000001
10000000000000000000000000001
10000000000000000000000000001
10000000000000000000000000001
11111110000000000000001122111
12222220000000000000001222221
12222220000000000000001222221
12222210000000000000001222221
12222210000000000000001222221
11111111111111111111111111111
